BBBBBBBBBBBBB...BBBBBBBB...BBBBBBBBBBBBB
BBBBBBBBBB....A..........A....BBBBBBBBBB
BBBBBBBB...AAAAAAAA..AAAAAAAA...BBBBBBBB
BBBBBBBB.AAAAAAAAAAAAAAAAAAAAAA.BBBBBBBB
BBBBBBB..AAAAAAAAAAAAAAAAAAAAAA..BBBBBBB
BBBBBBB.AAAAAAAAAAAAAAAAAAAAAAAA.BBBBBBB
BBBBBBB.AAAAAAAAAAAAAAAAAAAAAAAA.BBBBBBB
BBBBBBB.AAAAAAAAAAAAAAAAAAAAAAAA.BBBBBBB
BBBBBBB.AAAAAAAAAAAAAAAAAAAAAAAA.BBBBBBB
BBBBBBB.AAAAAAAAAAAAAAAAAAAAAAAA.BBBBBBB
BBBBBBB.AAAAAAAAAAAAAAAAAAAAAAAA.BBBBBBB
BBBBBBB..AAAAAAAAAAAAAAAAAAAAAA..BBBBBBB
BBBBBBBB.AAAAAAAAAAAAAAAAAAAAAA.BBBBBBBB
BBBBBBBB..AAAAAAAAAAAAAAAAAAAA..BBBBBBBB
BBBBBBBBB..AAAAAAAAAAAAAAAAAA..BBBBBBBBB
BBBBBBBBBB..AAAAAAAAAAAAAAAA..BBBBBBBBBB
BBBBBBBBBBB..AAAAAAAAAAAAAA..BBBBBBBBBBB
BBBBBBBBBBBB..AAAAAAAAAAAA..BBBBBBBBBBBB
BBBBBBBBBBBBB...AAAAAAAA...BBBBBBBBBBBBB
BBBBBBBBBBBBBBB..AAAAAA..BBBBBBBBBBBBBBB
BBBBBBBBBBBBBBBB...AA...BBBBBBBBBBBBBBBB
BBBBBBBBBBBBBBBBBB....BBBBBBBBBBBBBBBBBB
BBBBBBBBBBBBBBBBBBBBBBBBBBBBBBBBBBBBBBBB
BBBBBBBBBBBBBBBBBBBBBBBBBBBBBBBBBBBBBBBB
BBBBBBBBBBBBBBBBBBBBBBBBBBBBBBBBBBBBBBBB
