BBBBBBBBBBBBBBBBBBBBBBBBBBBBBBBBBBBBBBBB
BBBBBBBBBBBBBBBBBBBBBBBBBBBBBBBBBBBBBBBB
BBBBBBBBBBBBBBBBBB....BBBBBBBBBBBBBBBBBB
BBBBBBBBBBBBBBBBBB.AA.BBBBBBBBBBBBBBBBBB
BBBBBBBBBBB...BBBB.AA.BBBB...BBBBBBBBBBB
BBBBBBBBBBB.A.BBB..AA..BBB.A.BBBBBBBBBBB
BBBBBBBBBB..A..BB.AAAA.BB..A..BBBBBBBBBB
BBBBBBBBBB.AAA.B..AAAA..B.AAA.BBBBBBBBBB
BBBBBBBB...AAA...AAAAAA...AAA...BBBBBBBB
BBBBBBBB.AAAAAA..AAAAAA..AAAAAA.BBBBBBBB
BBBBBBBB.AAAAAA.AAAAAAAA.AAAAAA.BBBBBBBB
BBBBBBBB.AAAAAAAAAAAAAAAAAAAAAA.BBBBBBBB
BBBBBBB..AAAAAAAAAAAAAAAAAAAAAA..BBBBBBB
BBBBBBB.AAAAAAAAAAAAAAAAAAAAAAAA.BBBBBBB
BBBBBBB.AAAAAAAAAAAAAAAAAAAAAAAA.BBBBBBB
BBBBBBB.AAAAAAAAAAAAAAAAAAAAAAAA.BBBBBBB
BBBBBBB.AAAAAAAAAAAAAAAAAAAAAAAA.BBBBBBB
BBBBBBB.AAAAAAAAAAAAAAAAAAAAAAAA.BBBBBBB
BBBBBBB.AAAAAAAAAAAAAAAAAAAAAAAA.BBBBBBB
BBBBBBB..........................BBBBBBB
BBBBBBBBBBBBBBBBBBBBBBBBBBBBBBBBBBBBBBBB
BBBBBBBBBBBBBBBBBBBBBBBBBBBBBBBBBBBBBBBB
BBBBBBBBBBBBBBBBBBBBBBBBBBBBBBBBBBBBBBBB
BBBBBBBBBBBBBBBBBBBBBBBBBBBBBBBBBBBBBBBB
BBBBBBBBBBBBBBBBBBBBBBBBBBBBBBBBBBBBBBBB
