BBBBBBBBBBBBBBBBBBBBBBBBBBBBBBBBBBBBBBBB
BBBBBBBBBBBBBBBBBBBBBBBBBBBBBBBBBBBBBBBB
BBBBBBBBBBBBBBBBBB....BBBBBBBBBBBBBBBBBB
BBBBBBBBBBBBBBBBBB.AA.BBBBBBBBBBBBBBBBBB
BBBBBBBBBBBBBBBBBB.AA.BBBBBBBBBBBBBBBBBB
BBBBBBBBBBBBBBBBB..AA..BBBBBBBBBBBBBBBBB
BBBBBBBBBBBBBBBBB.AAAA.BBBBBBBBBBBBBBBBB
BBBBBBBBBBBBBBBBB.AAAA.BBBBBBBBBBBBBBBBB
BBBBBBBBBB........AAAA........BBBBBBBBBB
BBBBBBBBBB.AAAAAAAAAAAAAAAAAA.BBBBBBBBBB
BBBBBBBBBB..AAAAAAAAAAAAAAAA..BBBBBBBBBB
BBBBBBBBBBB..AAAAAAAAAAAAAA..BBBBBBBBBBB
BBBBBBBBBBBB..AAAAAAAAAAAA..BBBBBBBBBBBB
BBBBBBBBBBBBB...AAAAAAAA...BBBBBBBBBBBBB
BBBBBBBBBBBBBB..AAAAAAAA..BBBBBBBBBBBBBB
BBBBBBBBBBBBBB.AAAAAAAAAA.BBBBBBBBBBBBBB
BBBBBBBBBBBBBB.AAAAAAAAAA.BBBBBBBBBBBBBB
BBBBBBBBBBBBBB.AAAA..AAAA.BBBBBBBBBBBBBB
BBBBBBBBBBBBB..AA......AA..BBBBBBBBBBBBB
BBBBBBBBBBBBB.AA..BBBB..AA.BBBBBBBBBBBBB
BBBBBBBBBBBBB....BBBBBB....BBBBBBBBBBBBB
BBBBBBBBBBBBBBBBBBBBBBBBBBBBBBBBBBBBBBBB
BBBBBBBBBBBBBBBBBBBBBBBBBBBBBBBBBBBBBBBB
BBBBBBBBBBBBBBBBBBBBBBBBBBBBBBBBBBBBBBBB
BBBBBBBBBBBBBBBBBBBBBBBBBBBBBBBBBBBBBBBB
